int map[MAP_HEIGHT][MAP_WIDTH] = {
    {1, 1, 1, 1, 1, 1, 1, 1},
    {1, 0, 0, 0, 0, 0, 0, 1},
    {1, 0, 1, 1, 1, 1, 0, 1},
    {1, 0, 1, 0, 0, 1, 0, 1},
    {1, 0, 1, 0, 0, 1, 0, 1},
    {1, 0, 0, 0, 0, 0, 0, 1},
    {1, 1, 1, 1, 1, 1, 1, 1}
};
